0000000000000000
0011101110000000
0001001000000000
0001001110000000
0001001000000000
0001001110000000
0001001111101110
0010101010101010
0101011010101110
2222222222222222
2222222222222222
2222222222222222
0
0