0000000200000000
0000000000000000
0010001110110010
0010000100101010
0011101110100110
0000000000000000
0011110000100000
0001210001210000
0011110010101000
0000000000000000
0000000000000000
0000000200000000
0
0