1000210010002100
2100210021002100
2210000022000000
0020001000200010
0000111100001111
1000210010002100
1000210010002100
2100210021002100
2210000022100000
0020001000200010
0000111000001110
1000210010002100
3
0